1110 1110 1080 1090 1080 1090 1080 1090
0020 0020 1000 1030 1000 1000 1000 1050
1000 1000 1000 1000 1000 1000 1000 1000
1000 1000 1000 1000 1000 1000 1000 1000
1000 1000 1140 1130 0020 1140 1000 1000
1000 1000 1140 0020 0020 1140 1000 1000
1000 1000 1000 1000 1000 1000 1000 1000
1000 1000 1120 0010 1000 1000 1000 1000
music 01.ogg
info 4 2 Nothing on TV.
step 8 2 map001.map
rug 3 8 map003.map
