1210 1210 1210 1210 1210 1210 1240 1170 1170 1170 1170 1210 1240 1220 1220 1200 1200 1220 1220 1220 1220 1240 1210 1220 1220 1220 1220 1220 1220 1220 1220 1220
1210 1210 1210 1210 1210 1210 1240 1210 1210 1210 1210 1210 1240 1220 1220 1200 1200 1220 1220 1220 1220 1240 1210 1220 1220 1220 1220 1220 1220 1220 1220 1220
1210 1210 1210 1210 1210 1210 1240 1450 1450 1450 1450 1460 1240 1220 1220 1200 1200 1220 1220 1220 1220 1240 1210 1220 1220 1220 1220 1220 1220 1220 1220 1220
1210 1210 1210 1210 1210 1210 1240 1210 1210 1170 1170 1170 1170 1210 1210 1200 1200 1220 1220 1220 1220 1240 1210 1220 1220 1220 1220 1220 1220 1220 1220 1220
1210 1210 1210 1210 1210 1210 1240 1210 1210 1170 1170 1170 1170 1210 1210 1200 1200 1220 1220 1220 1220 1240 1210 1220 1220 1220 1220 1220 1220 1220 1220 1220
1210 1210 1210 1210 1210 1210 1240 1210 1210 1210 1210 1210 1210 1210 1210 1200 1200 1220 1220 1220 1220 1240 1210 1220 1220 1220 1220 1220 1220 1220 1220 1220
1210 1210 1210 1210 1210 1210 1240 1240 1240 1460 1460 1460 1460 1240 1240 1200 1200 1220 1220 1220 1220 1240 1210 1220 1220 1220 1220 1220 1220 1220 1220 1220
1210 1210 1210 1210 1210 1210 1230 1210 1210 1210 1210 1170 1170 1170 1170 1200 1200 1220 1220 1220 1220 1230 1210 1220 1220 1220 1220 1220 1220 1220 1220 1220
1210 1210 1210 1210 1210 1210 1230 1210 1210 1210 1210 1170 1170 1170 1170 1200 1200 1220 1220 1220 1220 1230 1210 1220 1220 1220 1220 1220 1220 1220 1220 1220
1210 1210 1210 1210 1210 1210 1230 1210 1210 1200 1200 1200 1200 1200 1200 1200 1200 1170 1170 1170 1170 1230 1210 1220 1220 1220 1220 1220 1220 1220 1220 1220
1210 1210 1210 1210 1210 1210 1230 1210 1210 1200 1200 1200 1200 1200 1200 1200 1200 1170 1170 1170 1170 1230 1210 1220 1220 1220 1220 1220 1220 1220 1220 1220
1210 1210 1210 1210 1210 1210 1230 1210 1210 1200 1200 1210 1210 1210 1210 1210 1210 1210 1210 1210 1210 1230 1210 1220 1220 1220 1220 1220 1220 1220 1220 1220
1210 1210 1210 1210 1210 1210 1230 1460 1450 1200 1200 1450 1460 1450 1460 1450 1460 1450 1460 1450 1460 1230 1210 1220 1220 1220 1220 1220 1220 1220 1220 1220
1210 1210 1210 1210 1210 1210 1230 1210 1210 1200 1200 1200 1200 1200 1200 1200 1200 1200 1200 1200 1200 1230 1210 1220 1220 1220 1220 1220 1220 1220 1220 1220
1210 1210 1210 1210 1210 1210 1230 1210 1210 1200 1200 1200 1200 1200 1200 1200 1200 1200 1200 1200 1200 1230 1210 1220 1220 1220 1220 1220 1220 1220 1220 1220
1210 1210 1210 1210 1210 1210 1230 1210 1210 1210 1210 1210 1210 1210 1210 1220 1220 1220 1220 1200 1200 1230 1210 1220 1220 1220 1220 1220 1220 1220 1220 1220
1210 1210 1210 1210 1210 1210 1230 1240 1240 1240 1240 1240 1240 1240 1240 1220 1220 1220 1220 1430 1440 1230 1210 1220 1220 1220 1220 1220 1220 1220 1220 1220
1210 1210 1210 1210 1210 1210 1230 1210 1210 1210 1210 1170 1170 1170 1170 1220 1220 1220 1220 1200 1200 1230 1210 1220 1220 1220 1220 1220 1220 1220 1220 1220
1210 1210 1210 1210 1210 1210 1230 1210 1210 1210 1210 1170 1170 1170 1170 1220 1220 1220 1220 1200 1200 1230 1210 1220 1220 1220 1220 1220 1220 1220 1220 1220
1210 1210 1210 1210 1210 1210 1230 1200 1200 1200 1200 1200 1200 1200 1200 1200 1200 1200 1200 1200 1200 1230 1210 1220 1220 1220 1220 1220 1220 1220 1220 1220
1220 1220 1220 1210 1210 1210 1230 1430 1440 1200 1200 1200 1260 1430 1440 1430 1440 1430 1440 1430 1440 1230 1210 1220 1220 1220 1220 1220 1220 1220 1220 1220
1220 1220 1220 1210 1210 1210 1240 1210 1210 1220 1220 1220 1220 1200 1200 1210 1210 1220 1220 1220 1220 1240 1210 1220 1220 1220 1220 1220 1220 1220 1220 1220
1220 1220 1220 1210 1210 1210 1240 1210 1210 1220 1220 1220 1220 1200 1200 1210 1210 1220 1220 1220 1220 1240 1210 1220 1220 1220 1220 1220 1220 1220 1220 1220
1220 1220 1220 1210 1210 1210 1240 1220 1220 1220 1220 1170 1170 1200 1200 1220 1220 1220 1220 1170 1170 1240 1210 1220 1220 1220 1220 1220 1220 1220 1220 1220
1220 1220 1220 1210 1210 1210 1240 1220 1220 1220 1220 1170 1170 1200 1200 1220 1220 1220 1220 1170 1170 1240 1210 1220 1220 1220 1220 1220 1220 1220 1220 1220
1220 1220 1220 1210 1210 1210 1240 1230 1230 1230 1230 1230 1230 1200 1200 1230 1230 1230 1230 1230 1230 1240 1210 1220 1220 1220 1220 1220 1220 1220 1220 1220
1220 1220 1220 1210 1210 1210 1240 1210 1210 1210 1210 1210 1230 1220 1220 1230 1210 1210 1210 1210 1210 1240 1210 1220 1220 1220 1220 1220 1220 1220 1220 1220
1220 1220 1220 1210 1210 1210 1240 1210 1210 1210 1210 1210 1230 1220 1220 1230 1210 1210 1210 1210 1210 1240 1210 1220 1220 1220 1220 1220 1220 1220 1220 1220
1220 1220 1220 1210 1210 1210 1240 1210 1210 1210 1210 1210 1230 1220 1220 1230 1210 1210 1210 1210 1210 1240 1210 1220 1220 1220 1220 1220 1220 1220 1220 1220
1220 1220 1220 1210 1210 1210 1230 1210 1210 1210 1210 1210 1230 1220 1220 1230 1210 1210 1210 1210 1210 1230 1210 1220 1220 1220 1220 1220 1220 1220 1220 1220
1220 1220 1220 1230 1230 1230 1230 1230 1230 1230 1230 1230 1230 1220 1220 1230 1230 1230 1230 1230 1230 1230 1230 1220 1220 1220 1220 1220 1220 1220 1220 1220
1220 1220 1220 1230 1210 1190 1180 1190 1180 1190 1180 1190 1180 1190 1180 1190 1180 1190 1180 1190 1180 1210 1230 1220 1220 1220 1220 1220 1220 1220 1220 1220
music 03.ogg
info 13 21 Route 1. Pallet Town - Viridian City
link 14 28 2 14 7 map003.map
bot 2 120 275 Hi! I work at a Pokémon Mart. It's a convenient shop, so please visit us in Viridian City. I know, I'll give you a sample! Here you go!
