1220 1220 1220 1210 1210 1210 1230 1430 1440 1200 1200 1200 1260 1430 1440 1430 1440 1430 1440 1430 1440 1230 1210 1220 1220 1220 1220 1220 1220 1220 1220 1220
1220 1220 1220 1210 1210 1210 1240 1210 1210 1220 1220 1220 1220 1200 1200 1210 1210 1220 1220 1220 1220 1240 1210 1220 1220 1220 1220 1220 1220 1220 1220 1220
1220 1220 1220 1210 1210 1210 1240 1210 1210 1220 1220 1220 1220 1200 1200 1210 1210 1220 1220 1220 1220 1240 1210 1220 1220 1220 1220 1220 1220 1220 1220 1220
1220 1220 1220 1210 1210 1210 1240 1220 1220 1220 1220 1170 1170 1200 1200 1220 1220 1220 1220 1170 1170 1240 1210 1220 1220 1220 1220 1220 1220 1220 1220 1220
1220 1220 1220 1210 1210 1210 1240 1220 1220 1220 1220 1170 1170 1200 1200 1220 1220 1220 1220 1170 1170 1240 1210 1220 1220 1220 1220 1220 1220 1220 1220 1220
1220 1220 1220 1210 1210 1210 1240 1230 1230 1230 1230 1230 1230 1200 1200 1230 1230 1230 1230 1230 1230 1240 1210 1220 1220 1220 1220 1220 1220 1220 1220 1220
1220 1220 1220 1210 1210 1210 1240 1210 1210 1210 1210 1210 1230 1220 1220 1230 1210 1210 1210 1210 1210 1240 1210 1220 1220 1220 1220 1220 1220 1220 1220 1220
1220 1220 1220 1210 1210 1210 1240 1210 1210 1210 1210 1210 1230 1220 1220 1230 1210 1210 1210 1210 1210 1240 1210 1220 1220 1220 1220 1220 1220 1220 1220 1220
1220 1220 1220 1210 1210 1210 1240 1210 1210 1210 1210 1210 1230 1220 1220 1230 1210 1210 1210 1210 1210 1240 1210 1220 1220 1220 1220 1220 1220 1220 1220 1220
1220 1220 1220 1210 1210 1210 1230 1210 1210 1210 1210 1210 1230 1220 1220 1230 1210 1210 1210 1210 1210 1230 1210 1220 1220 1220 1220 1220 1220 1220 1220 1220
1220 1220 1220 1230 1230 1230 1230 1230 1230 1230 1230 1230 1230 1220 1220 1230 1230 1230 1230 1230 1230 1230 1230 1220 1220 1220 1220 1220 1220 1220 1220 1220
1220 1220 1220 1230 1210 1190 1180 1190 1180 1190 1180 1190 1180 1190 1180 1190 1180 1190 1180 1190 1180 1210 1230 1220 1220 1220 1220 1220 1220 1220 1220 1220
1220 1220 1220 1230 1210 1180 1190 1160 0020 0020 0020 1180 1190 1180 1190 1180 1190 1180 1190 1180 1190 1210 1230 1220 1220 1220 1220 1220 1220 1220 1220 1220
1220 1220 1220 1230 1210 1200 1200 0020 0020 0020 0020 1190 1180 1200 1200 1480 0020 0020 0020 1190 1180 1210 1230 1220 1220 1220 1220 1220 1220 1220 1220 1220
1220 1220 1220 1230 1210 1200 1260 0020 0020 0020 0020 1180 1190 1200 1260 0020 0020 0020 0020 1180 1190 1210 1230 1220 1220 1220 1220 1220 1220 1220 1220 1220
1220 1220 1220 1230 1210 1190 1180 1190 1180 1190 1180 1190 1180 1190 1180 1190 1180 1190 1180 1190 1180 1210 1230 1220 1220 1220 1220 1220 1220 1220 1220 1220
1220 1220 1220 1230 1210 1180 1190 1180 1190 1180 1190 1180 1190 1180 1190 1180 1190 1180 1190 1180 1190 1210 1230 1220 1220 1220 1220 1220 1220 1220 1220 1220
1220 1220 1220 1230 1210 1190 1180 1200 1200 1200 1200 1190 1180 1150 0020 0020 0020 0020 0020 1190 1180 1210 1230 1220 1220 1220 1220 1220 1220 1220 1220 1220
1220 1220 1220 1230 1210 1180 1190 1250 1250 1250 1470 1180 1190 0020 0020 0020 0020 0020 0020 1180 1190 1210 1230 1220 1220 1220 1220 1220 1220 1220 1220 1220
1220 1220 1220 1230 1210 1190 1180 1170 1170 1170 1170 1190 1180 0020 0020 0020 0020 0020 0020 1190 1180 1210 1230 1220 1220 1220 1220 1220 1220 1220 1220 1220
1220 1220 1220 1230 1210 1180 1190 1170 1170 1170 1170 1180 1190 0020 0020 0020 0020 0020 0020 1180 1190 1210 1230 1220 1220 1220 1220 1220 1220 1220 1220 1220
1220 1220 1220 1230 1210 1190 1180 1190 1180 1190 1180 1190 1180 1200 1200 1200 1200 1200 1200 1200 1200 1210 1230 1220 1220 1220 1220 1220 1220 1220 1220 1220
1220 1220 1220 1230 1210 1180 1190 1180 1190 1180 1190 1180 1190 1250 1250 1250 1470 1250 1250 1200 1200 1210 1230 1220 1220 1220 1220 1220 1220 1220 1220 1220
1220 1220 1220 1230 1210 1210 1210 1320 1270 1270 1330 1200 1200 1170 1170 1170 1170 1210 1210 1200 1200 1210 1230 1220 1220 1220 1220 1220 1220 1220 1220 1220
1220 1220 1220 1230 1210 1210 1210 1300 1310 1310 1280 1200 1200 1170 1170 1170 1170 1210 1210 1200 1200 1210 1230 1220 1220 1220 1220 1220 1220 1220 1220 1220
1220 1220 1220 1230 1210 1210 1210 1300 1310 1310 1280 1200 1200 1200 1200 1200 1200 1200 1200 1200 1200 1210 1230 1220 1220 1220 1220 1220 1220 1220 1220 1220
1220 1220 1220 1230 1230 1210 1210 1300 1310 1310 1280 1230 1230 1230 1230 1230 1230 1230 1230 1230 1230 1230 1230 1220 1220 1220 1220 1220 1220 1220 1220 1220
1220 1220 1220 1230 1230 1230 1230 1300 1310 1310 1280 1230 1230 1230 1230 1230 1230 1230 1230 1230 1230 1230 1230 1220 1220 1220 1220 1220 1220 1220 1220 1220
1220 1220 1220 1210 1210 1210 1230 1300 1310 1310 1280 1210 1210 1210 1210 1210 1210 1230 1210 1210 1210 1210 1210 1220 1220 1220 1220 1220 1220 1220 1220 1220
1220 1220 1220 1210 1210 1210 1230 1300 1310 1310 1280 1210 1210 1170 1170 1170 1170 1230 1210 1210 1210 1210 1210 1220 1220 1220 1220 1220 1220 1220 1220 1220
1220 1220 1220 1210 1210 1210 1230 1300 1310 1310 1280 1210 1210 1210 1210 1210 1210 1230 1210 1210 1210 1210 1210 1220 1220 1220 1220 1220 1220 1220 1220 1220
1220 1220 1220 1210 1210 1210 1230 1300 1310 1310 1280 1210 1210 1210 1210 1210 1210 1230 1210 1210 1210 1210 1210 1220 1220 1220 1220 1220 1220 1220 1220 1220
music 01.ogg
door 9 15 map002.map
door 17 15 map004.map
info 7 15 Red's house
info 15 15 Green's house
info 11 19 Pallet Town - Shades of your journey await!
info 17 23 Professor Oak's Pokémon research lab
door 16 21 map005.map
link 14 5 2 14 26 map006.map
bot 1 100 250 I'm raising Pokémon too! When they get strong, they can protect me!
bot 2 240 370 Technology is incredible! You can now store and recall items and Pokémon as data via a PC!
