1370 1370 1080 1380 1080 1360 1080 1110
0020 0020 1000 1000 1000 1000 1000 0020
1000 1000 1000 1000 1000 1000 1000 1000
1000 1000 1140 1130 0020 1140 1000 1000
1000 1000 1140 0020 0020 1140 1000 1000
1000 1000 1000 1000 1000 1000 1000 1000
1060 1000 1000 1000 1000 1000 1000 1060
0020 1000 1410 0010 1000 1000 1000 0020
music 01.ogg
rug 3 8 map003.map
